Berikut ini merupakan provinsi di Indonesia beserta ibu kotanya.

Sumatra
 Aceh — Banda Aceh
 Sumatera Utara (Sumut) — Medan
 Sumatera Barat (Sumbar) — Padang
 Riau — Pekanbaru
 Jambi — Jambi
 Sumatera Selatan (Sumsel) — Palembang
 Bengkulu — Bengkulu
 Lampung — Bandar Lampung
 Kepulauan Bangka Belitung (Babel) — Pangkalpinang
 Kepulauan Riau (Kepri) — Tanjungpinang
Jawa
 Daerah Khusus Ibukota Jakarta (DKI Jakarta)
 Jawa Barat (Jabar) — Bandung
 Jawa Tengah (Jateng) — Semarang
 Daerah Istimewa Yogyakarta (DIY) — Yogyakarta[314]
 Jawa Timur (Jatim) — Surabaya
 Banten — Serang
Nusa Tenggara
 Bali — Denpasar
 Nusa Tenggara Barat (NTB) — Mataram
Nusa Tenggara Timur (NTT) — Kupang
Kalimantan
 Kalimantan Barat (Kalbar) — Pontianak
 Kalimantan Tengah (Kalteng) — Palangka Raya
 Kalimantan Selatan (Kalsel) — Banjarbaru
 Kalimantan Timur (Kaltim) — Samarinda
 Kalimantan Utara (Kaltara) — Tanjung Selor
Sulawesi
 Sulawesi Utara (Sulut) — Manado
 Sulawesi Tengah (Sulteng) — Palu
 Sulawesi Selatan (Sulsel) — Makassar
 Sulawesi Tenggara (Sultra) — Kendari
 Gorontalo — Gorontalo
 Sulawesi Barat (Sulbar) — Mamuju
Maluku
 Maluku — Ambon
 Maluku Utara (Malut) — Sofifi
Papua
 Papua — Jayapura
 Papua Barat (Pabar) — Manokwari
Papua Selatan (Pasel) — Merauke
Papua Tengah (Papteng) — Nabire
Papua Pegunungan (Papeg) — Wamena
Papua Barat Daya (PBD) — Sorong
Ibu kota negara
Artikel utama: Ibu kota Indonesia
Indonesia di IndonesiaJakartaJakartaYogyakartaYogyakartaBukittinggiBukittinggiNusantaraNusantara
Ibu kota negara Indonesia sepanjang sejarah
Hingga saat ini, ibu kota negara Republik Indonesia berkedudukan di Daerah Khusus Ibukota Jakarta.[315] Namun sejak tahun 2019, Pemerintah Indonesia melaksanakan proses pemindahan ibu kota Indonesia ke Ibu Kota Nusantara, yang direncanakan akan diresmikan pada tahun 2024.[316]
Semenjak kemerdekaan Indonesia pada tanggal 17 Agustus 1945, ibu kota negara Indonesia secara de facto berkedudukan di Jakarta. Ibu kota negara sempat dipindahkan ke Yogyakarta pada tanggal 4 Januari 1946 ketika pasukan Pemerintahan Sipil Hindia Belanda (NICA) menduduki Jakarta,[317] kemudian ke Bukittinggi pada tanggal 19 Desember 1948 ketika pemerintah pusat lumpuh karena ditawannya Presiden Soekarno dan Wakil Presiden Hatta oleh pasukan militer Belanda dan tampuk pemerintahan dipegang sementara oleh Pemerintahan Darurat Republik Indonesia (PDRI),[318] lalu kembali lagi ke Yogyakarta pada tanggal 6 Juli 1949 setelah kembalinya Soekarno-Hatta dari penawanan. Pada masa Republik Indonesia Serikat (RIS), ibu kota Negara Bagian Republik Indonesia berkedudukan di Yogyakarta sementara ibu kota federal RIS berada di Jakarta. Setelah kembali ke Negara Kesatuan Republik Indonesia pada tanggal 17 Agustus 1950, ibu kota negara kembali berkedudukan di Jakarta. Pada tanggal 28 Agustus 1961, Pemerintah mengeluarkan Peraturan Presiden Nomor 2 Tahun 1961 yang mengukuhkan status Jakarta sebagai ibu kota negara.[319] Pada tahun 2019, Presiden Joko Widodo melalui Pemerintah Pusat membuat kajian rancangan,[320] melakukan pencanangan,[321] dan menentukan letak wilayah dari ibu kota baru, yaitu sebagian dari wilayah Kabupaten Penajam Paser Utara dan Kutai Kartanegara.